***********************
*                     *
*         C           *
*                     *
*   +++++++++++++++   *
*   +++++++++++++++   *
*   +++++++++++++++   *
*   +++++++++++++++   *
*   +++++++++++++++   *
*   +++++++++++++++   *
*   +++++++++++++++   *
*   +++++++M+++++++   *
*   +++++++++++++++   *
*   +++++++++++++++   *
*   +++++++++++++++   *
*   +++++++++++++++   *
*   +++++++++++++++   *
*   +++++++++++++++   *
*   +++++++++++++++   *
*                     *
*         C           *
*                     *
***********************