***********************
*                     *
*                     *
*                     *
*   +++++++++++++++   *
*   +++++++++++++++   *
*   +++++++++++++++   *
*   +++++++++++++++   *
*   +++++++++++++++   *
*   +++++++++++++++   *
*   +++++++++++++++   *
*   +++++++M+++++++   *
*   +++++++++++++++   *
*   +++++++++++++++   *
*   +++++++++++++++   *
*   +++++++++++++++   *
*   +++++++++++++++   *
*   +++++++++++++++   *
*   +++++++++++++++   *
*          C          *
*                     *
*                     *
***********************