***********************
*+ +                  *
* + +                 *
*  + ++     ++ +   +  *
*   +++++++++++++++   *
* +++   +++++++++++ + *
* + ++++++++++++++++  *
*  +++++++ ++++++++   *
*  +++ +    ++++++++++*
*  ++++++  +++++++++  *
*   ++ +++  +++++++   *
*   +++ +++  ++++++   *
*   ++++ ++    + +++  *
*   +++ + +++++ + +   *
* +++++   +++++M+++C  *
*   ++++++ +++++++++  *
*   +++++ +++++++++   *
*   ++++  ++++++++++  *
*   + +  +++++++++++  *
*        +     +   ++ *
*                   ++*
*                     *
***********************
