***********************
*           * *       *
*                     *
*                     *
*   +*+++++++++++++   *
*   +++++++++++++*+   *
*   ++++++*+++++*++   *
*   +++++++++++++++   *
*   +*+++++++++++++*  *
*   +++++++++++++++   *
*   +++++*+++++++++   *
*   +++++++M+++++++   *
*   +++++++++++++++   *
*   +++++++*+++++++   *
*   +++++++++++++++   *
*   ++*++++*+++++++   *
*   ++++++*++++++++ * *
*   +++++++++++++++   *
*   +++++++++++++++   *
*                     *
*    **    *    *  *  *
*                     *
***********************