***********************
*  + C++              *
*  +++++              *
*   ++++M    +        *
*   +++      ++++++++ *
*   ++++    +++++++   *
*  ++++   +++++++++   *
*  +++++  +++++++++   *
*   +++++  ++++++++   *
*  ++++++++ +++++++   *
*   ++++++++++++++++  *
*  ++++++++  ++++++   *
*   +++++++ +++++++   *
*   ++++++  +++++++   *
*   +++++++ +++++++   *
*   +++++++++++++++   *
*   +++++++++++++++   *
*   +++++++++++++++   *
*   +++++++++++++++   *
*          +          *
*          +          *
*          +          *
***********************
