***********************
*+ +                  *
* + +                 *
*  + +       +     +  *
*   +++++++++++++++   *
* +++   +++++++++++ + *
* + ++++++++++++++++  *
*  ++++++++++++++++   *
*  +++ + ++++++++++   *
*  ++++++C+++++++++   *
*   ++M++++++++++++   *
*   +++ +++++++++++   *
*   ++++ ++ +++++++   *
*   +++ + +++++++++   *
* +++++   +++++++++   *
*   ++++++ ++++++++   *
*   +++++ +++++++++   *
*   ++++  +++++++++   *
*   + +  ++++++++++   *
*        +            *
*                     *
*                     *
***********************
