***********************
*    +++ +            *
*       +++     +     *
*       ++    ++      *
*   ++  +++++++++++   *
*   +++  +   +++++++++*
*  +++    ++ ++++++   *
*++++ ++     ++++++   *
* C ++ ++ ++ ++++++   *
*  ++++M ++++++++++++ *
* ++++ ++++++++++++   *
*++ +++ +++ +++++++   *
*   +  ++++++++++++   *
* C +   + +++++++++   *
*   ++   ++++++++++   *
*   ++ ++++++++++++   *
*   +++++++++++++++   *
*   +++++++++++++++   *
*  ++++++++++++++++   *
*  + + +    +         *
* +         +         *
*+          +         *
***********************
