***********************
*                     *
*                     *
*                     *
*   +++++++++++++++   *
*   +++++++++++++++   *
*   ++++++++ ++++++   *
*   ++++ +++ ++++++   *
*   +++++ ++ ++++++   *
*   ++++++++ ++++++   *
*   ++++++++   +++++++*
*   +C      M     C   *
*+  ++++++++ ++++ ++++*
*   ++++++++ ++++++   *
*   ++++++++ ++++++   *
*   ++++    C++++++   *
*   ++++++++ ++++++   *
*   ++++++++ ++++++   *
*   ++++++++ ++++++   *
*                     *
*                     *
*                     *
***********************