***********************
*                     *
*                     *
*                     *
*   +++++++++++++++   *
*   +++++++++++++++   *
*   +++++++++++++++   *
*   +++++++++++++++   *
*   +++++++++++++++   *
*   +++++++++++++++   *
*   ++++++++++++++++++*
*   +     C           *
*+  ++++++++ ++++ ++++*
*   +++++++C+++++++   *
*   ++++++++ ++++++   *
*   ++++++++ ++++++   *
*  +++++++M +++++++   *
*   +++++++++++++++   *
*   +++++++++++++++   *
*    +  +   +    +    *
*           +         *
*                     *
***********************
