***********************
*                     *
*                     *
*                     *
*   +++++++++++++++   *
*   +++++++++++++++   *
*   ++++++++ ++++++   *
*   ++++  ++ ++++++   *
*   +++++             *
*   +++++++++++++++   *
*   ++++++   ++++++   *
*   +++C +M+      +   *
*   ++++++ + ++++++   *
*   ++++++++ ++++++   *
*   +++++++++++++++   *
*   ++++++++++++ ++   *
*   +++  ++++ ++ ++   *
*   +++++++++++++++   *
*   +++++++++   +++   *
*                     *
*                     *
*                     *
***********************