***********************
*   ++ +  + + +   +   *
*  ++   + +    C  +   *
*  +   +++      M+++  *
*+++   +     +++++++  *
* +++       ++  ++++  *
*+++++   + ++ +    +  *
*   +  ++  +++++++    *
*   ++++++++++++++ +  *
*  +++++++++++  +  +  *
* + ++++++++  +++ ++  *
*   +++++++ ++    ++++*
*++++++++++++     +C  *
*  +++++++++++  +++   *
*   +++++++++++ +++   *
*   +++++++++++++++   *
*  ++++++++++++++++   *
*   ++++++++++++++++  *
*   +++++++++++++++   *
*        ++    + ++   *
*                +    *
*                +    *
***********************
