***********************
*++++C                *
* + +        +        *
*++++++     ++ +   +  *
*  ++++++++++++++++   *
*+  ++  +++++++++++ + *
*+   +++++++++++++++  *
*    +++++ ++++++++   *
*+++        ++++++++++*
*+ ++      +++++++++  *
*+ +  +++++++++++++   *
*    ++ +++  ++++++   *
*     +  +++   + +++  *
*++   +   +++++++ +   *
*+  ++++  +++++ +++   *
*   M ++++++++++++++  *
*++   +++++++++ +++   *
* + ++++++ ++++++    +*
*   ++++ ++++ ++  ++ +*
*    +   +      + ++  *
*             ++    ++*
*              +      *
***********************
