***********************
*                     *
*                     *
*           C         *
*   +++++++++++++++   *
*   +++++++++++++++   *
*   +++++++++++++++   *
*   +++++++++++++++   *
*   +++++++++++++++   *
*   +++++++++++++++   *
*   +++++++++++++++   *
*   +++++++ +++++++   *
*   +++++++ +++++++   *
*   +++++++ +++++++   *
*   +++++++M+++++++   *
*   +++++++++++++++   *
*   +++++++++++++++   *
*   +++++++++++++++   *
*   +++++++++++++++   *
*        C +          *
*          +          *
*          +          *
***********************
