***********************
*++  +C+ +            *
*++  +++ M++          *
*+    +      +        *
*+ +     ++++++++++++ *
*       +++++++++++   *
*  +++    +++++++++   *
*   +++++  +++++++++  *
*   ++++ ++++++++++   *
* ++++++  +++++++++   *
*  ++++++  +++++++++  *
*   ++++++ ++++++++   *
*   ++++++  +++++++   *
*   +++++   +++++++   *
*   +++++ ++ ++++++   *
*   ++++  +  ++++++   *
*   ++++  + +++++++   *
*   ++++  +++++++++   *
*   +++++++++++++++   *
*     +++ +++    +    *
*       +  +          *
*       +C +          *
***********************
