***********************
*                     *
*                     *
*                     *
*   +++++++++++++++   *
*   +++++++++++++++   *
*   +++++++++++++++   *
*   +++++++++++++++   *
*   +++++++++++++++   *
*   +++++++++++++++   *
*   ++++++++++++++++++*
*   +   C   M     C   *
*+  +++++++++++++ ++++*
*   +++++++++++++++   *
*   +++++++++++++++   *
*   +++++++++++++++   *
*   +++++++++++++++   *
*   +++++++++++++++   *
*   +++++++++++++++   *
*                     *
*                     *
*                     *
***********************