***********************
*  +H+++              *
*  +++++         +    *
*   +++      +   +    *
*   +++      ++++++++ *
*   ++++    +++++++   *
*  ++++       +++ ++++*
*  +++++  ++++  +M +C *
*   +++++  +++++  ++  *
*  ++++++++ +++++  ++ *
*   ++++++++++++++++  *
*  ++++++++  +++++++  *
*   +++++++ ++++++++  *
*   ++++++  +++++++   *
*   +++++++ +++++++   *
*   ++++++++++++++++  *
*   +++++++++++++++   *
*   +++++++++++++++   *
*   +++++++++++++++   *
*          +     +    *
*          +          *
*          +          *
***********************
