***********************
*                     *
*                     *
*                     *
*   +++++++++++++++   *
*   +++++++++++++++   *
*   ++++++++ ++++++   *
*   ++++  ++ ++++++   *
*   ++C++             *
*   ++ ++++++++++++   *
*   ++   +   ++++++   *
*   ++  M+ +      +   *
*   ++++++ + ++++++   *
*   ++++++++ ++++++   *
*   +++++++++++++++   *
*   ++++ +++++++ ++   *
*   +++  ++++ ++ ++   *
*   +++++++++++++++   *
*   +++++++++   +++   *
*                     *
*                     *
*                     *
***********************