***********************
*++++                 *
* + +        +        *
*++++++     ++ +   +  *
*  ++++++++++++++++   *
*+  ++  +++++++++++ + *
*+   +++++++++++++++  *
*    +++++ ++++++++   *
*+++        ++++++++++*
*+ ++      +++++++++  *
*+ +  +++++++++++++   *
*    ++ +++  ++++++   *
* M   +  +++   + +++  *
* +   +   +++++++ +   *
*++++ ++  +++++ +++   *
*C  +++++++++++ ++++  *
*   +++++ +++++ +++   *
*   ++++++ ++++++    +*
*   +++  ++++ ++  ++ +*
*        +      + ++  *
*             ++    ++*
*              +      *
***********************

