***********************
*      +              *
*      +    +         *
*   +  + + +     +    *
* C++++++++++++++++   *
*  + +   +++++++++++++*
*+++    +++  +++++++  *
*   +++ ++ ++ ++++++  *
*  + + ++ ++ ++  ++   *
*+++ ++   +++  ++ +   *
*   + + +++++++  +++  *
*   ++ + ++ +  +++++  *
*   +++  +++ ++++++   *
*   ++++ ++++++++++   *
* +++++  ++++++++++   *
* + +++ +++++++++++   *
*+  +++ +++++++++++   *
*  +++  +++++++++++   *
*   ++++++++++++++++  *
*   +C+++     ++   +  *
* M++ +++      +      *
*   +  ++       +     *
***********************
