***********************
*                     *
*                     *
*                     *
*   +++++++++++++++   *
*   +++++++++++++++   *
*   ++++++++ ++++++   *
*   ++++  ++ ++++++   *
*   +++++             *
*   +++++++++++++++   *
*   ++++     ++++++   *
*   +   ++++      +   *
*   ++++++ + ++++++   *
*   ++++++++ ++++++   *
*   +++++++++++++++   *
*   ++++++++++++ ++   *
*   +++  ++++ ++C++   *
*   +++++++++++++++   *
* C +++++++++   +++   *
*  M                  *
*                     *
*                     *
***********************