***********************
*                     *
*                     *
*                     *
*   +++++++++++++++   *
*   +++++++++++++++   *
*   ++++++++ ++++++   *
*   ++++  ++ ++++++   *
*   +++++             *
*   +++++++++++++++   *
*   ++++     ++++++   *
*   +             +   *
*   ++++++++ ++++++   *
*   ++++++++ ++++++   *
*   +++++++++++++++   *
*   ++++++++C++++++   *
*   ++++++++C++++++   *
*   ++++++++ ++++++   *
*   ++++++++ ++++++   *
*             M       *
*                     *
*                     *
***********************